SerialCmd	KEYWORD1
lastLine	KEYWORD1

ReadSer	KEYWORD2
AddCmd	KEYWORD2
ReadNext	KEYWORD2
ReadString	KEYWORD2
Print	KEYWORD2

SERIALCMD_FORCEUC	LITERAL1
SERIALCMD_MAXCMDNUM	LITERAL1
SERIALCMD_MAXCMDLNG	LITERAL1
SERIALCMD_MAXBUFFER	LITERAL1
SERIALCMD_PUBBUFFER	LITERAL1
SERIALCMD_FROMSTRING	LITERAL1
SERIALCMD_FROMALL	LITERAL1
SERIALCMD_FROMSERIAL	LITERAL1
SERIALCMD_CR	LITERAL1
SERIALCMD_LF	LITERAL1
SERIALCMD_NULL	LITERAL1
SERIALCMD_COMMA	LITERAL1
SERIALCMD_SEMICOL	LITERAL1
SERIALCMD_DOT	LITERAL1
SERIALCMD_SPACE	LITERAL1